#####################
#00000000#00#00######
#0#0#####0#0##000##0X
#0#0000##0#0000#0#00#
#0####0##0##0###0##0#
#0000#00000#0#0#00#0#
######0#####000#0#00#
E0000000#0000###0#0##
#######000##000#000##
#####################